13 67
0000000000000000000000000000000000000000000000000000000000000000000
0000000000000000000000000000000000000000000000000000000220022000000
0000000000000000000000000000000000000000000000000000002002200200000
0000000000000000000000000000002000000000000000000000000200002000000
0000000000000000000000000000200000000000000002000000000020020000000
1000000002000000002000020000000200000020000000000000000002200000000
0000000000000000200002000002000000200000200020000002000200002000200
0002000020000020000200002000000020000200002000200020202020020202020
0200020000020000020000200020000000020000000000002000000000000000000
000000s00000000000000000s000000001000000000000000000000001100000000
AB00002200000022000000002000000020200000220000200000000011110000000
1111100001111000011111100011111100011110000110001111111111111111111
1111111111111111111111111111111111111111111111111111111111111111111
