13 50
00000000000000000000000000000000000000000000000000
00000000000000000000000000000000000000000000000000
00000000000000000000000000000000000000000000000000
00000000000000000000000000000000000000000000000000
00000000000000000000000000000000000000000000000000
000000000000000D0000000D0000000D000000000000000000
AB00000000000D010D00000100000012222222210000000000
21000000000011222001212210022100000001122200121210
11S00S0D00X011111000012101110011100000111100001E10
11111111111111111111111111111111111111111111111111
11111111111111111111111111111111111111111111111111
11111111111111111111111111111111111111111111111111
11111111111111111111111111111111111111111111111111
