13 50
00000000000000000000000000000000000000000000000000
00000000000000000000000000000000000000000000000000
00000000000000000000000000000000000000000000000000
00000000000000000000000000000000000000000000000000
00000000000XX0000000000000000000000000000000000000
00000001000000000000000000000000000000000000000000
BA000011222222210000000100000001222222221000000000
21002211000000112220012122100221000000011222001212
11100111000001111000012101110011100000111100001E10
11111111111111111111111111111111111111111111111111
11111111111111111111111111111111111111111111111111
11111111111111111111111111111111111111111111111111
11111111111111111111111111111111111111111111111111
