0000000000000000000000000
0000000000000000000000000
0000000000000000000000000
0000000000000000000000000
0000000000000000000000000
0000000000000000000000000
0000001222222221000000000
2100221000000011222001212
1110011100000111100001010
1111111111111111111111111
1111111111111111111111111
1111111111111111111111111
1111111111111111111111111
