13 50
00000000000000000000000000000000000000000000000000
00000000000000000000000000000000000000000000000000
00000000000000000000000000000000000000000000000000
00000000000000000000000000000020000000000000000000
00000000000000000000000000002000000000000000020000
10000000020000000020000200000002000000200000000000
00000000000000002000020000020000002000002000200000
00020000200000200002000020000000200002000020002000
02000200000200000200002000200000000200000000000020
000000a0000000000000000000000000010000000000000000
AB000022000000220000000020000000202000002200002000
11111000011110000111111000111111000111100001100011
11111111111111111111111111111111111111111111111111
