13 50
00000000000000000000000000000000000000000000000000
00000000000000000000000000000000000000000000000000
00000000000000000000000000000000000000000000000000
00000000000000000000000000000020000000000000000000
000000000E0000000000000000002000000000000000020000
0000000002000000002000020000000200E000200000000000
00000F000000000020000200000200F00020000020E020E000
00020000200000200E02000020E00000200002000020002000
02000200000200000200002000200000000200000000000020
00000000000000000000000000000000010000000000000000
AB0000220000E022000E000020000E00202000E02200002000
11111000011110000111111000111111000111100001100011
11111111111111111111111111111111111111111111111111
