12 16
0000000000000000
0000000000000000
0000000000000000
0000000000000000
00000000M0000000
0000000000000000
0000000000000000
0000000000000000
0000000000000000
0000000000000000
NG00000000000000
1111111111111111