25 50
00000000000000000000000000000000000000000000000000
00000000000000000000000000000000000000000000000000
00000000000000000000000000000000000000000000000000
00000000000000000000000000000000000000000000000000
00000000000000000000000000000000000000000000000000
00000000000000000000000000000000000000000000000000
00000000000000000000000000000000000000000000000000
00000000000000000000000000000000000000000000000000
00000000000000000000000000000000000000000000000000
00000000000000000000000000000000000000000000000000
00000000000000000000000000000000000000000000000000
00000000000000000000000000000000000000000000000000
00000000000000000000000000000000000000000000000000
00000000000000000000000000000000000000000000000000
00000000000000000000000000000000000000000000000000
00000000000000000000000000000000000000000000000000
00000000004000000000000000000000000000000000000000
00000000004000000000000000000000000000000000000000
00000000004000000000000000000000000000000000000000
44444444444000444444000000000000000000000000000000
00000000004000000000000000000000000000000000000000
00000000004000000000000000000000000000000000000000
000X000000D000000000000000000000000000000000000000
44444444444444444444444444444444444444444444444444
44444444444444444444444444444444444444444444444444
