25 25
4444444444444444444444444
4NT3333333333333333333334
4333333333333333333333334
4333333333333333333333334
4333333333333333333333334
4333333333333333333333334
4333333333333333333333334
4333333333333333333333334
4333333333333333333333334
4333333333333333333333334
4333333333333333333333334
4333333333333333333333334
4333333333333333333333334
4333333333333333333333334
4333333333333333333333334
4333333333333333333333334
4333333333333333333333334
4333333333333333333333334
4333333333333333333333334
4333333333333333333333334
4333333333333333333333334
4333333333333333333333334
4333333333333333333333334
43333333333333333333333E4
4444444444444444444444444