25 50
00000000000000000000000000000000000000000000000000
00000000000000000000000000000000000000000000000000
00000000000000000000000000000000000000000000000000
00000000000000000000000000000000000000000000000000
00000000000000000000000000000000000000000000000000
00000000000000000000000000000000000000000000000000
00000000000000000000000000000000000000000000000000
00000000000000000000000000000000000000000000000000
00000000000000000000000000000000000000000000000000
00000000000000000000000000000000000000000000000000
00000000000000000000000000000000000000000000000000
00000000000000000000000000000000000000000000000000
00000000000000000000000000000000000000000000000000
00000000000000000000000000000000000000000000000000
00000000000000000000000000000000000000000000000000
00000000000000000000000000000000000000000000000000
00000000004000000004000000000400000000000000000000
00000000004000000004000000000400000000000000000000
00000000004000000X04X00000X00000000000000000000000
44444444444000444444440044444400000000000000000000
00000000004000000004000240000400000000000000000000
0000000000D00000000D000000000400000000000000000000
AB0S00S0000000000000000000000400000000000000000000
44444444444444444444444444444444444444444444444444
44444444444444444444444444444444444444444444444444
