25 50
00000000000000000000000000000000000000000000000000
00000000000000000000000000000000000000000000000000
0000000000X0X0000000000000000000000000000044444444
00000000044D44000000000000000000000000000040004444
0000004444000440000000000X00X000000000000040004444
000004400000004400000S44444444D4000000000040704444
00004440000000444000044000000004000000000040700060
00004400000000444400444000000004000000000047004444
00004400000000D00004444000000004000000000047004000
000040000X00S040444444400000X004000000000040704000
0000444D444444444444444000004444000000000040074000
000040070000000400000000S0444004000000000040704000
0X004070000000040000000044400004000000000040074000
04004700000000040000000440000004000000000047004000
00704700X00X000D0X07000040X00004000000000040704000
00044S44444444440400070044440004000000000047004000
00704444000000040070000740000004000000000040074000
S70000040000000407007000400S0004000000000047004000
444000B400000X04SX0000X0D0444004444444444440704000
0044D4440004444444000444444444D44000000040D0704000
40000004070000040007040000000400400000044040004000
44400004000000040007040000000400444444440740004000
0A07000D00000S0D0000S40000000DSX000000000440004000
444444S44444444444444444444444444444444S4444g44444
44444444444444444444444444444444444444444444444444