25 50
00000000000000000000000000000000000000000000000000
00000000000000000000000000000000000000000000000000
0000000000X0X0000000000000000000000000000044444444
00000000044D44000000000000000000000000000040004444
0000004444000440000000AB0X00X000000000000040004444
000004400000004400000S44444444D4000000000040204444
00004440000000444000044000000004000000000040200060
00004400000000444400444000000004000000000042004444
00004400000000D00004444000000004000000000040004000
000040000X00S040444444400000X004000000000040204000
0000444D444444444444444000004444000000000040024000
000040020000000400000000S0444004000000000040204000
0X004020000000040000000044400004000000000040024000
04004200000000040000000440000004000000000042004000
00204200X00X000D0X02000040X00004000000000040204000
00044S44444444440400020044440004000000000042004000
00204444000000040020000240000004000000000040024000
S20000040000000402002000400S0004000000000042004000
44400B0400000X04SX0000X0D0444004444444444440204000
0044D4440004444444000444444444D44000000040D0004000
40000004020000040002040000000400400000044040004000
44400004000000040002040000000400444444440240004000
0A02000D00000S0D0000040000000D0S0X0000000440004000
444444S44444444444444444444444444444444S4444444444
44444444444444444444444444444444444444444444444444