25 50
44444444444444444444444444444444444444444444444444
44444444444444444404444444444444404444444444444444
40000444000044400000000000000000000000044444444444
40X7044000000440000000000000000000000XS44444444444
44407440000004400000000000000000000004444444444444
40007400000000400000000000000000000070044000000044
40007400000000400000000000000000000007040000000004
40004400000000400000000000000000000070040000000004
40700400000000400000000000000000000007040000000004
47000400000000D000000000000000000000700D0000000004
40700400000007444444444400004444444444447000000004
40700400000070044444444440044444444444400700000004
470S0D00000700044440000007700000000044400070000004
44044444444444444440707070070707070744444007000004
00700000000000044440070707707070707000444000700006
00070000000000040000707070070707070707444444444444
44444444444444040707070700007070707070004444444444
000000000000Es740070707070070707070707004444444444
0000000000E077040707070700007070707070704444444444
000000000E70s0047000000000000000000000074444444444
BA000000070E70044444444444444444444444444444444444
44000000000700000000000000000000000000WW4444444444
440000000sEE7E000000000000000000000000WW4444444444
44444444444444444444444444444444444444444444444444
44444444444444444444444444444444444444444444444444
