25 25
4444444444444444444444444
4NT3335333333333333333334
4333333333333333333333334
4333333333333333333333334
4333333333333333333333334
4333333333333333333333334
4333333333333333333333334
4333333333333333333333334
4333333333333333333333334
4333333333333333333333334
4333333333333363333333334
4333333333333333333333334
4333333333333333333333334
4333333333333333333333334
4333333333333333333333334
4333333333333333333333334
4333333333333333333333334
4333333333333333333333334
4333333333333333333333334
4333333333333333333333334
4333333333333333333333334
4333333333333333333333334
4333333333333333333333334
4333333333333333333333334
4444444444444444444444444