12 16
0000000000000000
0000000000000000
00000000L0000000
0000000000000000
0000000000000000
0000000000000000
0000000000000000
0000000000000000
0000000000000000
AB00000000000000
1111111111111111
1111111111111111