12 16
0000000000000000
0000000000000000
00000000L0000000
0000000000000000
0000000000000000
0000000000000000
0000000000000000
0000000000000000
0000000000000000
0<30000000000000
4444444444444444
4444444444444444