12 16
0000000000000000
2222000000000000
22220000L0000000
2222000000000000
2222000000000000
2222000000000000
2222000000000000
2222000000000000
2222000000000000
<>22000000000000
1111111111111111
1111111111111111